..........................................................................................
.........................:::::::::::::::::::::::::........................................
................................................::::::....................................
...........................................:::::::::::::::::::............................
................::::::::::::::::::::::::::::::::::::......................................
...............::::::::::::::::::::::::...................................................
..............:::::::::::::@::::::::::::..................................................
................::::::::::::::::::::::::::::::............................................
.....................:::::::::::::.......::::::::::::.....................................
.........................................::::::...........................................
..........................................:::::::::::::...................................
.......................::::::::::::::::::::::::::::::.....................................
.................................:::::::::::..............................................
..................................::::::::::::::::::::::::................................
....................................:::::::::::::::::::::::...............................
.........................................:::::::::::::::::::..............................
.........................................:::::::::::::....................................
...........................................:::::::::::::::::::::..........................
...................................::::::::::::::::::::::::::::::::::::::::::::::::::::::.
...............................:::::::::::::::::::::::::::::::::::::::....................
.....................................::::::::::::::::::::::::::::::::::::::::.............
............................::::::::::::::::::::::::::::::::::::::::::....................
..........................:::::::::::::::::::::::::::::::.................................
..........................................................................................
..........................................................................................
..........................................................................................
..........................................................................................
..........................................................................................
.........................................................:::::::::::......................
.........................................:::::::::::::::::::..............................
................................................::::::::::................................